# *DO NOT DIRECTLY EDIT THIS FILE, IT IS AUTOMATICALLY GENERATED AND IT IS BASED ON:*
# https://docs.google.com/spreadsheet/ccc?key=0AmQEO36liL4FdDJLWVNMaVV2UmRKSnpXU09MYkdGbEE
aboutDrawio=Despre draw.io
actualSize=Dimensiunea Reală
add=Add
addImages=Add images
addImageUrl=Add image URL
addLayer=Add layer
addProperty=Add property
addToExistingDrawing=Adăugați la desenul existent
addWaypoint=Add waypoint
advanced=Advanced
align=Aliniază
alignment=Aliniere
allChangesLost=Toate modificările vor fi pierdute!
areYouSure=Are you sure?
ensureDataSaved=Please ensure your data is saved before closing.
allChangesSaved=All changes saved
allChangesSavedInDrive=All changes saved in Drive
allowPopups=Allow pop-ups to avoid this dialog.
alreadyConnected=Nodurile sunt deja conectate
apply=Aplică
arrange=Aranjează
arrow=Săgeată
arrows=Săgeți
asNew=As new
atlas=Atlas
authorizationRequired=Authorization required
authorizeThisAppIn=Authorize this app in {1}:
authorize=Authorize
authorizing=Authorizing
automatic=Automatic
autosave=Autosave
autosize=Auto-dimensionare
background=Background
backgroundColor=Culoare de fundal
backgroundImage=Background image
basic=De bază
blankDrawing=Desen gol
blankDiagram=Blank diagram
block=Bloc
blockquote=Blockquote
bold=Îngroșat
borderColor=Culoarea marginilor
borderWidth=Grosimea marginilor
bottom=Bază
bottomAlign=Aliniere in partea de jos
browser=Browser
bulletedList=Bulleted list
cancel=Anulare
center=Centrează
cannotLoad=Load attempts failed. Please try again later.
cannotLogin=Log in attempts failed. Please try again later.
change=Change
changeOrientation=Schimbă orientarea
changeUser=Change user
changesNotSaved=Changes have not been saved
chatJoined={1} has joined
chatLeft={1} has left
chatWindowTitle=Chat
chooseAnOption=Choose an option
chromeApp=Chrome App
circle=Cerc
classic=Clasic
clipart=Imagine
close=Închide
collaborator=Collaborator
collaborators=Collaborators
collapse=Micșorează
collapse-expand=Micșorează/Extinde
collapsible=Collapsible
commentsNotes=Comments/Notes
connect=Conectează
connecting=În curs de conectare
connectWithDrive=Connect with Google Drive
connection=Conexiune
connectionPoints=Connection points
containsValidationErrors=Conține erori de validare
copy=Copiere
copyConnect=Copy on connect
copyOf=Copy of
copyOfDrawing=Copierea desenului
copyStyle=Copy style
create=Create
createNewDiagram=Create new diagram
curved=Curved
custom=Personalizat
cut=Tăiere
dashed=Linie Punctată
delete=Ștergere
deleteColumn=Delete column
deleteRow=Delete row
device=Device
diagramLocked=Diagram has been locked to prevent further data loss.
diagramName=Diagram name
diamond=Romb
diamondThin=Romb (Subțire)
didYouKnow=Știați că...
direction=Direcție
discardChangesAndReconnect=Discard changes and reconnect
googleDriveMissing=Google Drive missing?
disconnected=Disconnected
distribute=Distribute
documentProperties=Document properties
done=Finalizat
dotted=Dotted
doubleClickOrientation=Efectuați dublu-click pentru a modifica orientarea
downloadAs=Download as
dragImagesHere=Drag images here
draw.io=draw.io
drawing=Desen{1}
drawingEmpty=Desenul este gol
drawingTooLarge=Desenul este prea mare
dropbox=Dropbox
duplicate=Duplicare
east=Est
edit=Editare
editData=Edit data
editGeometry=Edit geometry
editImage=Edit image
editImageUrl=Edit Image URL
editLink=Editare link
editText=Edit text
editTooltip=Edit tooltip
googleImages=Google Images
imageSearch=Image Search
email=Email
embed=Încorporați
mainEmbedNotice=Paste this into the page
embedNotice=Adăugați aceasta o singură dată la finalul paginii
enterGroup=Introduceți grup
enterName=Enter name
enterPropertyName=Enter property name
enterValue=Introduceți valoare
entityRelation=Relația între entități
error=Eroare
errorLoadingFile=Eroare la încărcarea fișierului
errorRenamingFile=Error renaming file.
errorRenamingFileNotFound=Error renaming file. File was not found.
errorRenamingFileForbidden=Error renaming file. Insufficient access rights.
errorSavingFile=Eroare la salvarea fișierului
errorSavingFileUnknown=Error authorizing with Google's servers. Please refresh the page to re-attempt.
errorSavingFileForbidden=Error saving file. Insufficient access rights.
errorSavingFileNotFound=Error saving file. File was not found.
errorSendingFeedback=Error sending feedback.
exit=Exit
exitGroup=Părăsiți grupul
expand=Extinde
export=Exportează
failedToSaveTryReconnect=Salvare eșuată, se încearcă reconectarea
featureRequest=Feature Request
feedback=Feedback
feedbackSent=Feedback successfully sent.
file=Fișier
filename=Nume Fișier
fileExists=File already exists
fileNotFound=Fișierul nu a fost găsit
fileNotFoundOrDenied=The file was not found. It does not exist or you do not have read access.
fileNotLoaded=Fișierul nu a fost încărcat
fileNotSaved=Fișierul nu a fost salvat
fileOpenLocation=How would you like to open these file(s)?
fileWillBeSavedInAppFolder={1} will be saved in the app folder.
fillColor=Culoarea de umplere
fit=Potrivește dimensiunea
fitPage=Potrivire cu dimensiunea paginii
fitPageWidth=Potrivire cu lățimea paginii
fitTwoPages=Two pages
fitWindow=Potrivește dimensiunea cu cea a ferestrei
flipH=Răsturnare pe orizontală
flipV=Răsturnare pe verticală
fontColor=Culoarea fontului
fontFamily=Familia de fonturi
fontSize=Dimensiunea fontului
forbidden=You are not authorized to access this file
format=Formatare
formatted=Formatted
formattedText=Formatted text
forum=Forumuri de Discuții/Ajutor
fromTemplate=Din Template
fromTemplateUrl=From template URL
fromText=Din Text
general=General
global=Global
googleDocs=Google Docs
googleDrive=Google Drive
googleGadget=Google Gadget
googlePlus=Google+
googleSites=Google Sites
gradient=Gradient
gradientColor=Culoare
grid=Grilă
gridSize=Grid size
group=Grupare
guides=Ghidaje
hateApp=I hate draw.io
heading=Heading
height=Înălțime
help=Ajutor
helpTranslate=Ajutați-ne să traducem această aplicație
hide=Ascunde
hideIt=Hide {1}
hidden=Hidden
home=Acasă
horizontal=Orizontal
horizontalFlow=Curgere Orizontală
horizontalTree=Arbore orizontal
html=HTML
htmlText=HTML text
iframe=IFrame
ignore=Ignore
image=Imagine
images=Imagini
import=Importare
importFrom=Import from
includeCopyOfMyDiagram=Include a copy of my diagram
increaseIndent=Increase indent
decreaseIndent=Descrease indent
inline=Inline
insert=Insert
insertColumnBefore=Insert column left
insertColumnAfter=Insert column right
insertImage=Insert image
insertHorizontalRule=Insert horizontal rule
insertLink=Insert link
insertRowBefore=Insert row above
insertRowAfter=Insert row after
inserting=Inserting
invalidName=Invalid name
invalidOrMissingFile=Fișier invalid sau inexistent
italic=Inclinat
kennedy=Kennedy
layer=Layer
layers=Layers
landscape=Peisaj
language=Limbă
lastChange=Last change {1} ago
lessThanAMinute=less than a minute
minute=minute
minutes=minutes
hours=hours
days=days
months=months
years=years
restartForChangeRequired=Changes will take effect after page refresh.
layout=Schemă
left=Stânga
leftAlign=Aliniere la Stânga
line=Linie
lineend=Final de Linie
linestart=Început de Linie
linewidth=Grosime linie
link=Link
loading=În curs de încărcare
lockUnlock=Lock/Unlock
loveApp=I love draw.io
mathematicalTypesetting=Mathematical typesetting
makeCopy=Make a copy
manual=Manual
middle=Mijloc
more=More
moreResults=Mai Multe Rezultate
moreShapes=Mai Multe Forme
move=Mutare
moveToFolder=Move to folder
moving=Moving
moveSelectionTo=Move selection to {1}
navigation=Navigare
needHelp=Need help?
new=Nou
newLibrary=New library
noColor=Fără culoare
noFiles=Nu există fișiere
noFileSelected=No file selected
noMoreResults=Nu mai există rezultate
none=Niciunul
noOtherViewers=No other viewers
noPlugins=No plugins
noResponse=No response from server
noResultsFor=Nu există rezultate pentru '{1}'
normal=Normal
north=Nord
notADiagramFile=Not a diagram file
notALibraryFile=Not a library file
notConnected=Neconectat
note=Note
notUsingService=Not using {1}?
numberedList=Numbered list
offline=Offline
ok=OK
opacity=Opacitate
open=Deschidere
openArrow=Săgeată deschisă
openExistingDiagram=Open existing diagram
openFile=Deschide fișier
openFrom=Open from
openLibrary=Open library
openLink=Deschide link
openInNewWindow=Deschide în fereastră nouă
openIt=Open {1}
openSupported=Formatul suportat este fișier .XML salvat cu acest software
options=Opțiuni
organic=Organic
orthogonal=Ortogonal
otherViewer=other viewer
otherViewers=other viewers
outline=Outline
oval=Oval
pages=Pagini
pageView=Stil de pagină
pageSetup=Reglaje pagină
pageScale=Zoom pagină
pan=Panoramare
paperSize=Dimensiuni Hârtie
paste=Lipire
pasteStyle=Paste style
perimeter=Perimetru
blue=Blue
green=Green
gray=Gray
turquoise=Turquoise
yellow=Yellow
red=Red
pink=Pink
publicDiagramUrl=Public URL of the diagram
purple=Purple
plain=Neted
plugins=Plugins
pluginUrl=Plugin URL
pluginWarning=The page has requested to load the following plugin(s):\n \n {1}\n \n Would you like to load these plugin(s) now?\n \n NOTE : Only allow plugins to run if you fully understand the security implications of doing so.\n
portrait=Portrait
position=Poziție
posterPrint=Imprimare Poster
preferences=Preferințele
preview=Previzualizare
print=Imprimare
properties=Properties
radialTree=Radial tree
readOnly=Read-only
reconnecting=Reconectare
redirectToPro=This file was created in draw.io pro. You will be redirected now.
convertToPro=The file will be converted for draw.io pro now.
realtimeTimeout=It looks like you've made a few changes while offline. We're sorry, these changes cannot be saved.
redo=Refacere
refresh=Refresh
rememberMe=Remember me
rememberThisSetting=Remember this setting
removeFormat=Clear formatting
removeFromGroup=Ștergere din grup
removeIt=Remove {1}
removeWaypoint=Remove waypoint
rename=Rename
renamed=Renamed
renameIt=Rename {1}
renaming=Renaming
replace={1} există deja. Doriți sa fie înlocuit?
replaceExistingDrawing=Înlocuire desen existent
required=required
reset=Resetare
resetWaypoints=Reset waypoints
resize=Redimensionare
retryingIn=Retrying in {1} second(s)
retryingLoad=Load failed. Retrying...
retryingLogin=Login time out. Retrying...
reverseEdge=Reverse edge
right=Dreapta
rightAlign=Aliniere la Dreapta
rotate=Rotire
rotation=Rotație
rounded=Rotunjit
save=Salvare
saveAs=Salvare cu titlu nou
saved=Salvat
saveDiagramsTo=Save diagrams to
saving=În curs de salvare
scrollbars=Bare de rulare
search=Căutare
selectAll=Selectează Totul
selectEdges=Selectează Marginile
selectFont=Selectează Fontul
selectVertices=Selectează noduri
sendMessage=Send
sendUsYourFeedback=Send us your feedback
serviceUnavailableOrBlocked=Service unavailable or blocked
sessionExpired=Your session has expired. Please refresh the browser window.
sessionTimeoutOnSave=Your session has timed out and you have been disconnected from the Google Drive. Press OK to login and save. 
setAsDefaultStyle=Set as default style
shadow=Umbră
shape=Formă
shapes=Forme
share=Sharing
shareLink=Link pentru editare în comun
sharingServerNotice=Notă: Conținut experimental. Folosiți-l doar pe răspunderea dumneavoastră.
sharingServerReady=Serverul de sharing este pregătit
sharingServerUnavailable=Serverul de sharing nu este disponibil
signOut=Deconectare
size=Dimensiune
sourceSpacing=Spațierea Sursei
south=Sud
spacing=Spațiere
specialLink=Special link
starting=Starting
straight=Drept
strokeColor=Culoarea liniei
style=Stil
subscript=Subscript
superscript=Superscript
support=Support
table=Table
targetSpacing=Spațierea țintei
template=Template
templates=Templates
text=Text
textAlignment=Aliniere Text
textOpacity=Opacitate Text
theme=Theme
tilt=Tilt
timeout=Timeout
toBack=Înapoi
toFront=Înainte
tooltips=Sfaturi
top=Vârf
topAlign=Aliniere la Vârf
transparent=Transparent
tryAgain=Try again
underline=Subliniere
undo=Anulare actiune anterioara
ungroup=Degrupare
unsavedChanges=Unsaved changes
untitledDiagram=Untitled Diagram
untitledLibrary=Untitled Library
unknownError=Unknown error
updatingDocument=Actualizare Document. Vă rugăm așteptați...
updatingSelection=Actualizare Selecție. Vă rugăm așteptați
upload=Upload
url=URL
vertical=Vertical
verticalFlow=Curgere Verticală
verticalTree=Arbore Vertical
view=Vizualizare
west=Vest
width=Lărgime
wordWrap=Word wrap
zoom=Zoom
zoomIn=Apropiere
zoomOut=Îndepărtare
basic=Basic
businessprocess=Business processes
charts=Charts
engineering=Engineering
flowcharts=Flowcharts
mindmaps=Mindmaps
mockups=Mockups
networkdiagrams=Network diagrams
other=Other
softwaredesign=Software design
venndiagrams=Venn diagrams
wireframes=Wireframes
