# *DO NOT DIRECTLY EDIT THIS FILE, IT IS AUTOMATICALLY GENERATED AND IT IS BASED ON:*
# https://docs.google.com/spreadsheet/ccc?key=0AmQEO36liL4FdDJLWVNMaVV2UmRKSnpXU09MYkdGbEE
aboutDrawio=A propos de draw.io
actualSize=Taille réelle
add=Add
addImages=Add images
addImageUrl=Add image URL
addLayer=Add layer
addProperty=Add property
addToExistingDrawing=Ajouter au diagramme existant
addWaypoint=Add waypoint
advanced=Advanced
align=Aligner
alignment=Alignement
allChangesLost=Toutes les modifications seront perdues!
areYouSure=Are you sure?
ensureDataSaved=Please ensure your data is saved before closing.
allChangesSaved=All changes saved
allChangesSavedInDrive=All changes saved in Drive
allowPopups=Allow pop-ups to avoid this dialog.
alreadyConnected=Nœuds déjà connectés
apply=Appliquer
arrange=Organiser
arrow=Flèche
arrows=Flèches
asNew=As new
atlas=Atlas
authorizationRequired=Authorization required
authorizeThisAppIn=Authorize this app in {1}:
authorize=Authorize
authorizing=Authorizing
automatic=Automatic
autosave=Autosave
autosize=Taille automatique
background=Background
backgroundColor=Couleur de fond
backgroundImage=Background image
basic=Basique
blankDrawing=Diagramme vierge
blankDiagram=Blank diagram
block=Bloc
blockquote=Blockquote
bold=Gras
borderColor=Couleur de la bordure
borderWidth=Largeur de la bordure
bottom=En bas
bottomAlign=Aligner en bas
browser=Browser
bulletedList=Bulleted list
cancel=Annuler
center=Centrer
cannotLoad=Load attempts failed. Please try again later.
cannotLogin=Log in attempts failed. Please try again later.
change=Change
changeOrientation=Modifier l’orientation
changeUser=Change user
changesNotSaved=Changes have not been saved
chatJoined={1} has joined
chatLeft={1} has left
chatWindowTitle=Chat
chooseAnOption=Choose an option
chromeApp=Chrome App
circle=Cercle
classic=Classique
clipart=Clipart
close=Fermer
collaborator=Collaborator
collaborators=Collaborators
collapse=Réduire
collapse-expand=Réduire-Developper
collapsible=Collapsible
commentsNotes=Comments/Notes
connect=Connecter
connecting=Connexion en cours
connectWithDrive=Connect with Google Drive
connection=Connexion
connectionPoints=Connection points
containsValidationErrors=Contient des erreurs de validation
copy=Copier
copyConnect=Copy on connect
copyOf=Copy of
copyOfDrawing=Copie d'un diagramme
copyStyle=Copy style
create=Create
createNewDiagram=Create new diagram
curved=Curved
custom=Personnalisé
cut=Couper
dashed=Pointillé
delete=Supprimer
deleteColumn=Delete column
deleteRow=Delete row
device=Device
diagramLocked=Diagram has been locked to prevent further data loss.
diagramName=Diagram name
diamond=Losange
diamondThin=Losange fin
didYouKnow=Le savez vous...
direction=Orientation
discardChangesAndReconnect=Discard changes and reconnect
googleDriveMissing=Google Drive missing?
disconnected=Disconnected
distribute=Distribute
documentProperties=Document properties
done=Achevé
dotted=Dotted
doubleClickOrientation=Double-cliquer pour modifier l’orientation
downloadAs=Download as
dragImagesHere=Drag images here
draw.io=draw.io
drawing=Diagramme{1}
drawingEmpty=Le diagramme est vide
drawingTooLarge=Le diagramme est trop grand
dropbox=Dropbox
duplicate=Dupliquer
east=Est
edit=Modifier
editData=Edit data
editGeometry=Edit geometry
editImage=Edit image
editImageUrl=Edit Image URL
editLink=Modifier le lien
editText=Edit text
editTooltip=Edit tooltip
googleImages=Google Images
imageSearch=Image Search
email=Email
embed=Intégrer
mainEmbedNotice=Paste this into the page
embedNotice=Ajouter ce code à la fin de votre page
enterGroup=Entrer une valeur
enterName=Enter name
enterPropertyName=Enter property name
enterValue=Saisir une valeur
entityRelation=Relation entre les éléments
error=Erreur
errorLoadingFile=Erreur au chargement du fichier
errorRenamingFile=Error renaming file.
errorRenamingFileNotFound=Error renaming file. File was not found.
errorRenamingFileForbidden=Error renaming file. Insufficient access rights.
errorSavingFile=Erreur à la sauvegarde du fichier
errorSavingFileUnknown=Error authorizing with Google's servers. Please refresh the page to re-attempt.
errorSavingFileForbidden=Error saving file. Insufficient access rights.
errorSavingFileNotFound=Error saving file. File was not found.
errorSendingFeedback=Error sending feedback.
exit=Exit
exitGroup=Quitter le groupe
expand=Developper
export=Exporter
failedToSaveTryReconnect=La sauvegarde à echouée, tentative de reconnexion
featureRequest=Feature Request
feedback=Feedback
feedbackSent=Feedback successfully sent.
file=Fichier
filename=Nom de fichier
fileExists=File already exists
fileNotFound=Fichier non trouvé
fileNotFoundOrDenied=The file was not found. It does not exist or you do not have read access.
fileNotLoaded=Fichier non chargé
fileNotSaved=Fichier non sauvegardé
fileOpenLocation=How would you like to open these file(s)?
fileWillBeSavedInAppFolder={1} will be saved in the app folder.
fillColor=Couleur de remplissage
fit=Ajuster
fitPage=Ajuster à la page
fitPageWidth=Ajuster à la largeur de la page
fitTwoPages=Two pages
fitWindow=Ajuster à la fenêtre
flipH=Retourner horizontalement
flipV=Retourner verticalement
fontColor=Couleur de la police
fontFamily=Police
fontSize=Taille de la police
forbidden=You are not authorized to access this file
format=Format
formatted=Formatted
formattedText=Formatted text
forum=Forum d'aide
fromTemplate=Depuis un modèle
fromTemplateUrl=From template URL
fromText=Depuis du texte
general=Général
global=Global
googleDocs=Google Docs
googleDrive=Google Drive
googleGadget=Google Gadget
googlePlus=Google+
googleSites=Google Sites
gradient=Dégradé
gradientColor=Couleur de dégradé
grid=Grille
gridSize=Grid size
group=Grouper
guides=Guides
hateApp=I hate draw.io
heading=Heading
height=Hauteur
help=Aide
helpTranslate=Aidez nous à traduire cette application
hide=Masquer
hideIt=Hide {1}
hidden=Hidden
home=Accueil
horizontal=Horizontal
horizontalFlow=Flux horizontal
horizontalTree=Arbre horizontal
html=HTML
htmlText=HTML text
iframe=IFrame
ignore=Ignore
image=Image
images=Images
import=Importer
importFrom=Import from
includeCopyOfMyDiagram=Include a copy of my diagram
increaseIndent=Increase indent
decreaseIndent=Descrease indent
inline=Inline
insert=Insert
insertColumnBefore=Insert column left
insertColumnAfter=Insert column right
insertImage=Insert image
insertHorizontalRule=Insert horizontal rule
insertLink=Insert link
insertRowBefore=Insert row above
insertRowAfter=Insert row after
inserting=Inserting
invalidName=Invalid name
invalidOrMissingFile=Fichier invalide ou manquant
italic=Italique
kennedy=Kennedy
layer=Layer
layers=Layers
landscape=Paysage
language=Langue
lastChange=Last change {1} ago
lessThanAMinute=less than a minute
minute=minute
minutes=minutes
hours=hours
days=days
months=months
years=years
restartForChangeRequired=Changes will take effect after page refresh.
layout=Modèle
left=Gauche
leftAlign=Aligner à gauche
line=Ligne
lineend=Fin de la ligne
linestart=Début de la ligne
linewidth=Largeur de la ligne
link=Link
loading=Chargement
lockUnlock=Lock/Unlock
loveApp=I love draw.io
mathematicalTypesetting=Mathematical typesetting
makeCopy=Make a copy
manual=Manual
middle=Au milieu
more=More
moreResults=Plus de résultats
moreShapes=Plus d'icones
move=Deplacer
moveToFolder=Move to folder
moving=Moving
moveSelectionTo=Move selection to {1}
navigation=Navigation
needHelp=Need help?
new=Nouveau
newLibrary=New library
noColor=Pas de couleur
noFiles=Pas de fichiers
noFileSelected=No file selected
noMoreResults=Pas d'autres résultats trouvés
none=Aucun
noOtherViewers=No other viewers
noPlugins=No plugins
noResponse=No response from server
noResultsFor=Pas de résultats pour '{1}'
normal=Normal
north=Nord
notADiagramFile=Not a diagram file
notALibraryFile=Not a library file
notConnected=Non connecté
note=Note
notUsingService=Not using {1}?
numberedList=Numbered list
offline=Offline
ok=OK
opacity=Opacité
open=Ouvrir
openArrow=Ouvrir la flèche
openExistingDiagram=Open existing diagram
openFile=Ouvrir le fichier
openFrom=Open from
openLibrary=Open library
openLink=Ouvrir le lien
openInNewWindow=Ouvrir dans une nouvelle fenêtre
openIt=Open {1}
openSupported=Les fichiers supportés sont les fichiers XML sauvegardés depuis ce logiciel
options=Options
organic=Organique
orthogonal=Orthogonale
otherViewer=other viewer
otherViewers=other viewers
outline=Outline
oval=Ovale
pages=Pages
pageView=Mise en page
pageSetup=Paramètres de la page
pageScale=Echelle de la page
pan=Panoramique
paperSize=Taille du papier
paste=Coller
pasteStyle=Paste style
perimeter=Périmètre
blue=Blue
green=Green
gray=Gray
turquoise=Turquoise
yellow=Yellow
red=Red
pink=Pink
publicDiagramUrl=Public URL of the diagram
purple=Purple
plain=Brut
plugins=Plugins
pluginUrl=Plugin URL
pluginWarning=The page has requested to load the following plugin(s):\n \n {1}\n \n Would you like to load these plugin(s) now?\n \n NOTE : Only allow plugins to run if you fully understand the security implications of doing so.\n
portrait=Portrait
position=Position
posterPrint=Données de l’impression
preferences=Préférences
preview=Aperçu
print=Imprimer
properties=Properties
radialTree=Radial tree
readOnly=Read-only
reconnecting=Reconnection
redirectToPro=This file was created in draw.io pro. You will be redirected now.
convertToPro=The file will be converted for draw.io pro now.
realtimeTimeout=It looks like you've made a few changes while offline. We're sorry, these changes cannot be saved.
redo=Refaire
refresh=Refresh
rememberMe=Remember me
rememberThisSetting=Remember this setting
removeFormat=Clear formatting
removeFromGroup=Retirer du groupe
removeIt=Remove {1}
removeWaypoint=Remove waypoint
rename=Rename
renamed=Renamed
renameIt=Rename {1}
renaming=Renaming
replace={1} existe déjà. Voulez-vous le remplacer?
replaceExistingDrawing=Remplacer le diagramme existant
required=required
reset=Reinistialiser
resetWaypoints=Reset waypoints
resize=Redimensionner
retryingIn=Retrying in {1} second(s)
retryingLoad=Load failed. Retrying...
retryingLogin=Login time out. Retrying...
reverseEdge=Reverse edge
right=Droit
rightAlign=Aligner à droite
rotate=Pivoter
rotation=Rotation
rounded=Arrondi
save=Enregistrer
saveAs=Enregistrer sous
saved=Enregistré
saveDiagramsTo=Save diagrams to
saving=Enregistrement
scrollbars=Barres de défilement
search=Chercher
selectAll=Tout sélectionner
selectEdges=Selectionner les bordures
selectFont=Sélectionner une police
selectVertices=Sélectionner des sommets
sendMessage=Send
sendUsYourFeedback=Send us your feedback
serviceUnavailableOrBlocked=Service unavailable or blocked
sessionExpired=Your session has expired. Please refresh the browser window.
sessionTimeoutOnSave=Your session has timed out and you have been disconnected from the Google Drive. Press OK to login and save. 
setAsDefaultStyle=Set as default style
shadow=Ombre
shape=Forme
shapes=Formes
share=Partager
shareLink=Lien pour l'édition partagée
sharingServerNotice=Note: Fonctionnalité experimentale.
sharingServerReady=Le serveur de partage est fonctionnel
sharingServerUnavailable=Le serveur de partage n'est pas disponible
signOut=Se deconnecter
size=Taille
sourceSpacing=Espacement de la source
south=Sud
spacing=Espacement
specialLink=Special link
starting=Starting
straight=Droit
strokeColor=Couleur de la ligne
style=Style
subscript=Subscript
superscript=Superscript
support=Support
table=Table
targetSpacing=Espacement de la cible
template=Template
templates=Templates
text=Texte
textAlignment=Justifier le texte
textOpacity=Opacité du texte
theme=Theme
tilt=Tilt
timeout=Timeout
toBack=Placer en dessous
toFront=Placer au-dessus
tooltips=Bulle d'information
top=En haut
topAlign=Aligner en haut
transparent=Transparent
tryAgain=Try again
underline=Souligné
undo=Annuler
ungroup=Dissocier
unsavedChanges=Unsaved changes
untitledDiagram=Untitled Diagram
untitledLibrary=Untitled Library
unknownError=Unknown error
updatingDocument=Mise à jour du document. Veuillez patienter...
updatingSelection=Mise à jour de la sélection. Veuillez patienter...
upload=Upload
url=URL
vertical=Vertical
verticalFlow=Flux vertical
verticalTree=Arbre vertical
view=Vue
west=Ouest
width=Largeur
wordWrap=Word wrap
zoom=Zoom
zoomIn=Agrandir
zoomOut=Réduire
basic=Basic
businessprocess=Business processes
charts=Charts
engineering=Engineering
flowcharts=Flowcharts
mindmaps=Mindmaps
mockups=Mockups
networkdiagrams=Network diagrams
other=Other
softwaredesign=Software design
venndiagrams=Venn diagrams
wireframes=Wireframes
