# *DO NOT DIRECTLY EDIT THIS FILE, IT IS AUTOMATICALLY GENERATED AND IT IS BASED ON:*
# https://docs.google.com/spreadsheet/ccc?key=0AmQEO36liL4FdDJLWVNMaVV2UmRKSnpXU09MYkdGbEE
aboutDrawio=Über draw.io
actualSize=Tatsächliche Grösse
add=Einfügen
addImages=Bilder hinzufügen
addImageUrl=Bild URL hinzufügen
addLayer=Ebene hinzufügen
addProperty=Eigenschaft einfügen
addToExistingDrawing=In vorhandene Zeichnung einfügen
addWaypoint=Wegpunkt einfügen
advanced=Erweitert
align=Ausrichten
alignment=Ausrichtung
allChangesLost=Alle Änderungen gehen verloren!
areYouSure=Sind Sie sicher?
ensureDataSaved=Bitte stellen Sie sicher, dass Ihre Daten gespeichert sind.
allChangesSaved=Alle Änderungen gespeichert
allChangesSavedInDrive=Alle Änderungen in Drive gespeichert
allowPopups=Popups zulassen um diesen Dialog zu verhindern.
alreadyConnected=Knoten schon verbunden
apply=Anwenden
arrange=Anordnen
arrow=Pfeil
arrows=Pfeile
asNew=Als Neu
atlas=Atlas
authorizationRequired=Autorisierung erforderlich
authorizeThisAppIn=Autorisieren Sie diese App bei {1}:
authorize=Autorisieren
authorizing=Wird autorisiert
automatic=Automatisch
autosave=Automatisch speichern
autosize=Grösse anpassen
background=Hintergrund
backgroundColor=Hintegrundfarbe
backgroundImage=Hintergrundbild
basic=Einfach
blankDrawing=Leere Zeichnung
blankDiagram=Leeres Diagramm
block=Block
blockquote=Zitat
bold=Fett
borderColor=Rahmenfarbe
borderWidth=Rahmenbreite
bottom=Unten
bottomAlign=Unten
browser=Browser
bulletedList=Aufzählungsliste
cancel=Abbrechen
center=Zentriert
cannotLoad=Load attempts failed. Please try again later.
cannotLogin=Log in attempts failed. Please try again later.
change=Ändern
changeOrientation=Orientierung ändern
changeUser=Benutzer ändern
changesNotSaved=Änderungen wurden nicht gespeichert
chatJoined={1} hat den Chat betreten
chatLeft={1} hat den Chat verlassen
chatWindowTitle=Chat
chooseAnOption=Wählen Sie eine Option
chromeApp=Chrome App
circle=Kreis
classic=Klassisch
clipart=Clipart
close=Schliessen
collaborator=Betrachter
collaborators=Betrachter
collapse=Einklappen
collapse-expand=Einklappen/Ausklappen
collapsible=Einklappbar
commentsNotes=Kommentare/Notizen
connect=Verbinden
connecting=Verbindungsaufbau
connectWithDrive=Mit Google Drive verbinden
connection=Verbindung
connectionPoints=Verbindungspunkte
containsValidationErrors=Enthält Validierungsfehler
copy=Kopieren
copyConnect=Beim Verbinden kopieren
copyOf=Kopie von
copyOfDrawing=Kopie der Zeichnung
copyStyle=Style kopieren
create=Erstellen
createNewDiagram=Neues Diagramm erstellen
curved=Gebogen
custom=Benutzerdefiniert
cut=Ausschneiden
dashed=Gestrichelt
delete=Löschen
deleteColumn=Spalte löschen
deleteRow=Zeile löschen
device=Gerät
diagramLocked=Diagram has been locked to prevent further data loss.
diagramName=Diagrammname
diamond=Diamant
diamondThin=Diamant (Schmal)
didYouKnow=Wussten Sie schon...
direction=Richtung
discardChangesAndReconnect=Änderungen verwerfen und neu verbinden
googleDriveMissing=Google Drive fehlt?
disconnected=Keine Verbindung
distribute=Verteilen
documentProperties=Dokumenteigenschaften
done=Fertig
dotted=Punktiert
doubleClickOrientation=Doppelklicken um Orientierung zu ändern
downloadAs=Herunterladen als
dragImagesHere=Bilder hierher ziehen
draw.io=draw.io
drawing=Zeichnung{1}
drawingEmpty=Zeichnung ist leer
drawingTooLarge=Zeichnung ist zu gross
dropbox=Dropbox
duplicate=Duplizieren
east=Ost
edit=Bearbeiten
editData=Daten bearbeiten
editGeometry=Geometrie bearbeiten
editImage=Bild bearbeiten
editImageUrl=Bild-URL bearbeiten
editLink=Link bearbeiten
editText=Text bearbeiten
editTooltip=Tooltip bearbeiten
googleImages=Google Bilder
imageSearch=Bildersuche
email=Email
embed=Einbetten
mainEmbedNotice=Fügen Sie dies in die Seite ein
embedNotice=Fügen Sie dies einmal am Ende der Seite ein
enterGroup=In Gruppe hinein
enterName=Namen eingeben
enterPropertyName=Eigenschaftsname eingeben
enterValue=Wert eingeben
entityRelation=Entity Relation
error=Fehler
errorLoadingFile=Fehler beim Laden der Datei
errorRenamingFile=Fehler beim Umbenennen der Datei.
errorRenamingFileNotFound=Fehler beim Umbenennen der Datei. Datei wurde nicht gefunden.
errorRenamingFileForbidden=Fehler beim Umbenennen der Datei. Ungenügende Zugriffsrechte.
errorSavingFile=Fehler beim Speichern der Datei
errorSavingFileUnknown=Error authorizing with Google's servers. Please refresh the page to re-attempt.
errorSavingFileForbidden=Fehler beim Speichern der Datei. Ungenügende Zugriffsrechte.
errorSavingFileNotFound=Fehler beim Speichern der Datei. Datei wurde nicht gefunden.
errorSendingFeedback=Fehler beim versenden des Feedback.
exit=Beenden
exitGroup=Aus Gruppe heraus
expand=Ausklappen
export=Exportieren
failedToSaveTryReconnect=Speichern fehlgeschlagen. Verbindungswiederherstellung
featureRequest=Feature Request
feedback=Feedback
feedbackSent=Feedback erfolgreich versendet.
file=Datei
filename=Dateiname
fileExists=Datei existiert bereits
fileNotFound=Datei nicht gefunden
fileNotFoundOrDenied=Die Datei wurde nicht gefunden. Entweder sie existiert nicht oder Sie haben keine Leseberechtigung.
fileNotLoaded=Datei nicht geladen
fileNotSaved=Datei nicht gespeichert
fileOpenLocation=Wie möchten Sie diese Datei(en) öffnen?
fileWillBeSavedInAppFolder={1} wird im Verzeichnis der App gespeichert.
fillColor=Füllfarbe
fit=Einpassen
fitPage=Ganze Seite
fitPageWidth=Seitenbreite
fitTwoPages=Zwei Seiten
fitWindow=An Fenstergrösse anpassen
flipH=Horizontal Spiegeln
flipV=Vertikal Spiegeln
fontColor=Schriftfarbe
fontFamily=Schriftart
fontSize=Schriftgrösse
forbidden=Zugriff verweigert
format=Format
formatted=Formatiert
formattedText=Formatierter Text
forum=Diskussion/Hilfe Foren
fromTemplate=Aus Vorlage
fromTemplateUrl=Vorlage von URL
fromText=Aus Text
general=Allgemein
global=Global
googleDocs=Google Docs
googleDrive=Google Drive
googleGadget=Google Gadget
googlePlus=Google+
googleSites=Google Sites
gradient=Farbverlauf
gradientColor=Farbe
grid=Gitternetz
gridSize=Gitternetzgrösse
group=Gruppieren
guides=Führungslinien
hateApp=Ich hasse draw.io
heading=Überschrift
height=Höhe
help=Hilfe
helpTranslate=Hilf uns diese Anwendung zu übersetzen
hide=Verstecken
hideIt={1} verstecken
hidden=Versteckt
home=Ursprung
horizontal=Horizontal
horizontalFlow=Horizontaler Fluss
horizontalTree=Horizontaler Baum
html=HTML
htmlText=HTML Text
iframe=IFrame
ignore=Ignorieren
image=Bild
images=Bilder
import=Importieren
importFrom=Importieren von
includeCopyOfMyDiagram=Kopie meines Diagramms mitsenden
increaseIndent=Einzug vergrössern
decreaseIndent=Einzug verringern
inline=Kein Absatz
insert=Einfügen
insertColumnBefore=Spalte links einfügen
insertColumnAfter=Spalte rechts einfügen
insertImage=Bild einfügen
insertHorizontalRule=Horizontale Linie einfügen
insertLink=Link einfügen
insertRowBefore=Zeile oberhalb einfügen
insertRowAfter=Zeile unterhalb einfügen
inserting=Wird eingefügt
invalidName=Ungültiger Name
invalidOrMissingFile=Ungültige oder fehlende Datei
italic=Kursiv
kennedy=Kennedy
layer=Ebene
layers=Ebenen
landscape=Querformat
language=Sprache
lastChange=Letzte Änderung vor {1}
lessThanAMinute=weniger als einer Minute
minute=Minute
minutes=Minuten
hours=Stunden
days=Tagen
months=Monaten
years=Jahren
restartForChangeRequired=Änderungen sind nach dem Neuladen der Seite wirksam.
layout=Layout
left=Links
leftAlign=Links
line=Linie
lineend=Linienende
linestart=Linienanfang
linewidth=Linienbreite
link=Link
loading=Wird geladen
lockUnlock=Sperren/Entsperren
loveApp=Ich liebe draw.io
mathematicalTypesetting=Mathematischer Formelsatz
makeCopy=Kopie erstellen
manual=Manuell
middle=Mitte
more=Mehr
moreResults=Mehr Resultate
moreShapes=Mehr Shapes
move=Verschieben
moveToFolder=In Ordner verschieben
moving=Wird verschoben
moveSelectionTo=Markierung in {1} einfügen
navigation=Navigation
needHelp=Benötigen Sie Hilfe?
new=Neu
newLibrary=Neue Bibliothek
noColor=Keine Farbe
noFiles=Keine Dateien
noFileSelected=Keine Datei ausgewählt
noMoreResults=Keine Weiteren Resultate
none=Keine
noOtherViewers=Keine weiteren Betrachter
noPlugins=No plugins
noResponse=Keine Antowort vom Server
noResultsFor=Keine Resultate für '{1}'
normal=Normal
north=Nord
notADiagramFile=Keine Diagrammdatei
notALibraryFile=Keine Bibliotheksdatei
notConnected=Nicht verbunden
note=Hinweis
notUsingService=Sie verwenden nicht {1}?
numberedList=Nummerierte Liste
offline=Offline
ok=OK
opacity=Deckkraft
open=Öffnen
openArrow=Offen
openExistingDiagram=Vorhandenes Diagramm öffnen
openFile=Datei öffnen
openFrom=Öffnen von
openLibrary=Bibliothek öffnen
openLink=Link öffnen
openInNewWindow=In neuem Fenster öffnen
openIt={1} öffnen
openSupported=Unterstützte Formate sind mit dieser Anwendung erstellte Dateien (.xml) und Visio Dateien (.vdx)
options=Optionen
organic=Organisch
orthogonal=Orthogonal
otherViewer=weiterer Betrachter
otherViewers=weitere Betrachter
outline=Übersicht
oval=Oval
pages=Seiten
pageView=Seitenansicht
pageSetup=Seite einrichten
pageScale=Seitenskalierung
pan=Verschieben
paperSize=Papiergrösse
paste=Einfügen
pasteStyle=Style einfügen
perimeter=Umfang
blue=Blau
green=Grün
gray=Grau
turquoise=Türkis
yellow=Gelb
red=Rot
pink=Rosarot
publicDiagramUrl=Öffentliche URL des Diagramms
purple=Violett
plain=Einfach
plugins=Plugins
pluginUrl=Plugin URL
pluginWarning=Die Seite hat das Laden folgender Plugins angefordert:\n \n {1}\n \n Möchten Sie diese Plugins jetzt laden?\n \n HINWEIS: Erlauben Sie das Ausführen der Plugins nur, wenn Sie die Sicherheitsimplikationen verstehen.
portrait=Hochformat
position=Position
posterPrint=Posterdruck
preferences=Einstellungen
preview=Vorschau
print=Drucken
properties=Eigenschaften
radialTree=Radialer Baum
readOnly=Nur Lesen
reconnecting=Verbindungswiederherstellung
redirectToPro=Diese Datei wurde mit draw.io pro erstellt. Sie werden nun weitergeleitet.
convertToPro=Die Datei wird für draw.io pro konvertiert.
realtimeTimeout=It looks like you've made a few changes while offline. We're sorry, these changes cannot be saved.
redo=Wiederherstellen
refresh=Aktualisieren
rememberMe=Angemeldet bleiben
rememberThisSetting=Diese Einstellung speichern
removeFormat=Formatierung entfernen
removeFromGroup=Aus Gruppe entfernen
removeIt={1} entfernen
removeWaypoint=Wegpunkt entfernen
rename=Umbenennen
renamed=Umbenannt
renameIt={1} umbenennen
renaming=Wird umbenannt
replace={1} existiert bereits. Soll die Datei überschrieben werden?
replaceExistingDrawing=Vorhandene Zeichnung ersetzen
required=erforderlich
reset=Zurücksetzen
resetWaypoints=Wegpunkte zurücksetzen
resize=Grösse anpassen
retryingIn=Versuche erneut in {1} Sekunde(n)
retryingLoad=Laden fehlgeschlagen. Versuche erneut...
retryingLogin=Zeitüberschreitung beim Anmelden. Versuche erneut...
reverseEdge=Kante umdrehen
right=Rechts
rightAlign=Rechts
rotate=Rotieren
rotation=Rotation
rounded=Abgerundet
save=Speichern
saveAs=Speichern unter
saved=Gespeichert
saveDiagramsTo=Diagramme speichern in
saving=Wird gespeichert
scrollbars=Scrollbars
search=Suchen
selectAll=Alles markieren
selectEdges=Kanten markieren
selectFont=Schriftart wählen
selectVertices=Knoten markieren
sendMessage=Senden
sendUsYourFeedback=Senden Sie uns Ihr Feedback
serviceUnavailableOrBlocked=Service nicht verfügbar oder geblockt
sessionExpired=Ihre Sitzung wurde beendet. Bitte aktualisieren Sie das Browserfenster.
sessionTimeoutOnSave=Your session has timed out and you have been disconnected from the Google Drive. Press OK to login and save. 
setAsDefaultStyle=Als Standardstyle festlegen
shadow=Schatten
shape=Shape
shapes=Shapes
share=Freigeben
shareLink=Link zum gemeinsamen Bearbeiten
sharingServerNotice=Hinweis: Experimentelles Feature. Benutzung auf eigene Gefahr!
sharingServerReady=Freigabeserver ist bereit.
sharingServerUnavailable=Freigabeserver ist nicht verfügbar.
signOut=Abmelden
size=Grösse
sourceSpacing=Anfangsabstand
south=Süd
spacing=Abstand
specialLink=Besonderer Link
starting=Wird gestartet
straight=Gerade
strokeColor=Linienfarbe
style=Style
subscript=Tiefgestellt
superscript=Hochgestellt
support=Support
table=Tabelle
targetSpacing=Endabstand
template=Vorlage
templates=Vorlagen
text=Text
textAlignment=Text Ausrichtung
textOpacity=Text Deckkraft
theme=Theme
tilt=Kippen
timeout=Zeitüberschreitung
toBack=Nach hinten
toFront=Nach vorne
tooltips=Tooltips
top=Oben
topAlign=Oben
transparent=Transparent
tryAgain=Erneut versuchen
underline=Unterstrichen
undo=Rückgängig
ungroup=Gruppierung aufheben
unsavedChanges=Ungesicherte Änderungen
untitledDiagram=Unbenanntes Diagramm
untitledLibrary=Unbenannte Bibliothek
unknownError=Unbekannter Fehler
updatingDocument=Aktualisiere Dokument. Bitte warten...
updatingSelection=Aktualisiere Markierung. Bitte warten...
upload=Hochladen
url=URL
vertical=Vertikal
verticalFlow=Vertikaler Fluss
verticalTree=Vertikaler Baum
view=Ansicht
west=West
width=Breite
wordWrap=Autom. Zeilenumbruch
zoom=Zoom
zoomIn=Hineinzoomen
zoomOut=Herauszoomen
basic=Einfach
businessprocess=Geschäftsprozesse
charts=Grafiken
engineering=Technik
flowcharts=Ablaufdiagramme
mindmaps=Mindmaps
mockups=Mockups
networkdiagrams=Netzwerkdiagramme
other=Andere
softwaredesign=Software Design
venndiagrams=Venn Diagramme
wireframes=Drahtgittermodelle
