# *DO NOT DIRECTLY EDIT THIS FILE, IT IS AUTOMATICALLY GENERATED AND IT IS BASED ON:*
# https://docs.google.com/spreadsheet/ccc?key=0AmQEO36liL4FdDJLWVNMaVV2UmRKSnpXU09MYkdGbEE
aboutDrawio=Tietoja draw.io-sovelluksesta
actualSize=Oikea koko
add=Add
addImages=Add images
addImageUrl=Add image URL
addLayer=Add layer
addProperty=Add property
addToExistingDrawing=Lisää olemassa olevaan piirustukseen
addWaypoint=Add waypoint
advanced=Advanced
align=Tasaus
alignment=Sovita
allChangesLost=Kaikki muutokset menetään!
areYouSure=Are you sure?
ensureDataSaved=Please ensure your data is saved before closing.
allChangesSaved=All changes saved
allChangesSavedInDrive=All changes saved in Drive
allowPopups=Allow pop-ups to avoid this dialog.
alreadyConnected=Solmut ovat yhdistetty jo
apply=Käytä
arrange=Sovita
arrow=Nuoli
arrows=Nuolet
asNew=As new
atlas=Atlas
authorizationRequired=Authorization required
authorizeThisAppIn=Authorize this app in {1}:
authorize=Authorize
authorizing=Authorizing
automatic=Automatic
autosave=Autosave
autosize=Automaattinen koko
background=Background
backgroundColor=Taustaväri
backgroundImage=Background image
basic=Tavalliset
blankDrawing=Tyhjä piirustus
blankDiagram=Blank diagram
block=Blokki
blockquote=Blockquote
bold=Lihavoitu
borderColor=Reunan väri
borderWidth=Reunan leveys 
bottom=Alasivu
bottomAlign=Alasivun tasaus 
browser=Browser
bulletedList=Bulleted list
cancel=Peruuta
center=Keskusta
cannotLoad=Load attempts failed. Please try again later.
cannotLogin=Log in attempts failed. Please try again later.
change=Change
changeOrientation=Vaihda suuntaa
changeUser=Change user
changesNotSaved=Changes have not been saved
chatJoined={1} has joined
chatLeft={1} has left
chatWindowTitle=Chat
chooseAnOption=Choose an option
chromeApp=Chrome App
circle=Ympyrä
classic=Klassinen
clipart=Clipart
close=Sulje
collaborator=Collaborator
collaborators=Collaborators
collapse=Tiivistä
collapse-expand=Tiivistä/Laajenna
collapsible=Collapsible
commentsNotes=Comments/Notes
connect=Yhdistä
connecting=Yhdistetään
connectWithDrive=Yhdistä Google Driveen
connection=Yhteys
connectionPoints=Connection points
containsValidationErrors=Sisältää kelpoisuustarkistusvirheitä
copy=Kopioi
copyConnect=Copy on connect
copyOf=Copy of
copyOfDrawing=Kopio piirustuksesta
copyStyle=Copy style
create=Create
createNewDiagram=Create new diagram
curved=Curved
custom=Mukautettu
cut=Leikkaa
dashed=Viivamerkit
delete=Poista
deleteColumn=Delete column
deleteRow=Delete row
device=Device
diagramLocked=Diagram has been locked to prevent further data loss.
diagramName=Diagram name
diamond=Timantti
diamondThin=Timantti (ohut)
didYouKnow=Tiesitkö, että...
direction=Suunta
discardChangesAndReconnect=Discard changes and reconnect
googleDriveMissing=Google Drive missing?
disconnected=Disconnected
distribute=Distribute
documentProperties=Document properties
done=Valmis
dotted=Dotted
doubleClickOrientation=Tupla-klikkaa muuttaaksesi suuntaa
downloadAs=Download as
dragImagesHere=Drag images here
draw.io=draw.io
drawing=Piirustus{1}
drawingEmpty=Piirustus on tyhjä
drawingTooLarge=Piirustus on liian iso
dropbox=Dropbox
duplicate=Jäljennä
east=Itä
edit=Muokkaa
editData=Edit data
editGeometry=Edit geometry
editImage=Edit image
editImageUrl=Edit Image URL
editLink=Muokkaa linkkiä
editText=Edit text
editTooltip=Edit tooltip
googleImages=Google Images
imageSearch=Image Search
email=Email
embed=Upota
mainEmbedNotice=Paste this into the page
embedNotice=Lisää tämä sivun loppuun
enterGroup=Syötä ryhmä
enterName=Enter name
enterPropertyName=Enter property name
enterValue=Syötä arvo 
entityRelation=Kokonaisuussuhde
error=Virhe
errorLoadingFile=Virhe tiedoston lataamisessa
errorRenamingFile=Error renaming file.
errorRenamingFileNotFound=Error renaming file. File was not found.
errorRenamingFileForbidden=Error renaming file. Insufficient access rights.
errorSavingFile=Virhe tiedoston tallentamisessa
errorSavingFileUnknown=Error authorizing with Google's servers. Please refresh the page to re-attempt.
errorSavingFileForbidden=Error saving file. Insufficient access rights.
errorSavingFileNotFound=Error saving file. File was not found.
errorSendingFeedback=Error sending feedback.
exit=Exit
exitGroup=Poistu ryhmästä
expand=Laajenna
export=Vie
failedToSaveTryReconnect=Tallentaminen epäonnistui, yritä yhdistämistä myöhemmin uudelleen
featureRequest=Feature Request
feedback=Feedback
feedbackSent=Feedback successfully sent.
file=Tiedosto
filename=Tiedostonimi
fileExists=File already exists
fileNotFound=Tiedostoa ei löydetty
fileNotFoundOrDenied=The file was not found. It does not exist or you do not have read access.
fileNotLoaded=Tiedostoa ei ladattu
fileNotSaved=Tiedostoa ei tallennettu
fileOpenLocation=How would you like to open these file(s)?
fileWillBeSavedInAppFolder={1} will be saved in the app folder.
fillColor=Täyteväri
fit=Sovita
fitPage=Sovita sivu
fitPageWidth=Sovita sivun leveys
fitTwoPages=Two pages
fitWindow=Sovita ikkuna
flipH=Käännä vaakasuunnassa
flipV=Käännä pystysuunnassa
fontColor=Fontin väri
fontFamily=Fonttiperhe
fontSize=Fontin koko
forbidden=You are not authorized to access this file
format=Muoto
formatted=Formatted
formattedText=Formatted text
forum=Keskustelu-/Apu-foorumit
fromTemplate=Mallipohjasta
fromTemplateUrl=From template URL
fromText=Tekstistä
general=Yleinen
global=Globaali
googleDocs=Google Docs
googleDrive=Google Drive
googleGadget=Google Gadget
googlePlus=Google+
googleSites=Google Sites
gradient=Liukuvärjäys
gradientColor=Väri
grid=Ruudukko
gridSize=Grid size
group=Ryhmitä
guides=Apuviivat
hateApp=I hate draw.io
heading=Heading
height=Korkeus
help=Apu
helpTranslate=Auta meitä kääntämään sovellus
hide=Piilota
hideIt=Hide {1}
hidden=Hidden
home=Koti
horizontal=Vaakasuunta
horizontalFlow=Vaakasuuntainen vuo
horizontalTree=Puunäkymä vaakasuunnassa
html=HTML
htmlText=HTML text
iframe=IFrame
ignore=Ignore
image=Kuva
images=Kuvat
import=Tuo
importFrom=Import from
includeCopyOfMyDiagram=Include a copy of my diagram
increaseIndent=Increase indent
decreaseIndent=Descrease indent
inline=Tekstinsisäinen
insert=Insert
insertColumnBefore=Insert column left
insertColumnAfter=Insert column right
insertImage=Insert image
insertHorizontalRule=Insert horizontal rule
insertLink=Insert link
insertRowBefore=Insert row above
insertRowAfter=Insert row after
inserting=Inserting
invalidName=Invalid name
invalidOrMissingFile=Epäkelvollinen tai puuttuva tiedosto
italic=Kursivoitu
kennedy=Kennedy
layer=Layer
layers=Layers
landscape=Vaakakuva
language=Kieli
lastChange=Last change {1} ago
lessThanAMinute=less than a minute
minute=minute
minutes=minutes
hours=hours
days=days
months=months
years=years
restartForChangeRequired=Changes will take effect after page refresh.
layout=Asettelu
left=Vasen
leftAlign=Vasen tasaus 
line=Rivi
lineend=Rivin loppu
linestart=Rivin alku
linewidth=Rivin leveys
link=Link
loading=Ladataan
lockUnlock=Lock/Unlock
loveApp=I love draw.io
mathematicalTypesetting=Mathematical typesetting
makeCopy=Make a copy
manual=Manual
middle=Keskellä
more=More
moreResults=Lisää tuloksia
moreShapes=Lisää muotoja
move=Liikuta 
moveToFolder=Move to folder
moving=Moving
moveSelectionTo=Move selection to {1}
navigation=Suuntaaminen
needHelp=Need help?
new=Uusi
newLibrary=New library
noColor=Ei väriä
noFiles=Ei tiedostoja
noFileSelected=No file selected
noMoreResults=Ei enempää tuloksia
none=Ei yhtään
noOtherViewers=No other viewers
noPlugins=No plugins
noResponse=No response from server
noResultsFor=Ei tuloksia haulle '{1}'
normal=Normal
north=Pohjoinen
notADiagramFile=Not a diagram file
notALibraryFile=Not a library file
notConnected=Ei ole yhdistetty
note=Note
notUsingService=Not using {1}?
numberedList=Numbered list
offline=Offline
ok=OK
opacity=Peittävyys
open=Avaa
openArrow=Avaa nuoli
openExistingDiagram=Open existing diagram
openFile=Avaa tiedosto
openFrom=Open from
openLibrary=Open library
openLink=Avaa linkki
openInNewWindow=Avaa uuteen ikkunaan
openIt=Open {1}
openSupported=Tuettu formaatti on .XML-tiedostot, jotka ovat tallennettu tällä ohjelmalla
options=Vaihtoehdot
organic=Orgaaninen
orthogonal=Suorakulma
otherViewer=other viewer
otherViewers=other viewers
outline=Outline
oval=Ovaali
pages=Sivut
pageView=Sivun katselu
pageSetup=Sivun asetukset
pageScale=Sivuasteikko
pan=Panoraama
paperSize=Paperin koko
paste=Liitä
pasteStyle=Paste style
perimeter=Perimetri
blue=Blue
green=Green
gray=Gray
turquoise=Turquoise
yellow=Yellow
red=Red
pink=Pink
publicDiagramUrl=Public URL of the diagram
purple=Purple
plain=Käsittelemätön
plugins=Plugins
pluginUrl=Plugin URL
pluginWarning=The page has requested to load the following plugin(s):\n \n {1}\n \n Would you like to load these plugin(s) now?\n \n NOTE : Only allow plugins to run if you fully understand the security implications of doing so.\n
portrait=Portrait
position=Paikka
posterPrint=Julistetulostus
preferences=Preferences
preview=Esikatsele
print=Tulosta
properties=Properties
radialTree=Radial tree
readOnly=Read-only
reconnecting=Yhdistetään uudelleen
redirectToPro=This file was created in draw.io pro. You will be redirected now.
convertToPro=The file will be converted for draw.io pro now.
realtimeTimeout=It looks like you've made a few changes while offline. We're sorry, these changes cannot be saved.
redo=Toista
refresh=Refresh
rememberMe=Remember me
rememberThisSetting=Remember this setting
removeFormat=Clear formatting
removeFromGroup=Poista ryhmityksestä
removeIt=Remove {1}
removeWaypoint=Remove waypoint
rename=Rename
renamed=Renamed
renameIt=Rename {1}
renaming=Renaming
replace={1} on jo olemassa. Haluatko korvata sen?
replaceExistingDrawing=Korvaa olemassa oleva piirustus
required=required
reset=Tyhjennä
resetWaypoints=Reset waypoints
resize=Muuta koko
retryingIn=Retrying in {1} second(s)
retryingLoad=Load failed. Retrying...
retryingLogin=Login time out. Retrying...
reverseEdge=Reverse edge
right=Oikea
rightAlign=Oikea tasaus
rotate=Kierrä
rotation=Kiertäminen
rounded=Pyöristetty
save=Tallenna
saveAs=Tallenna nimellä
saved=Tallennettu
saveDiagramsTo=Save diagrams to
saving=Tallennetaan
scrollbars=Vierityspalkit
search=Etsi
selectAll=Valitse kaikki
selectEdges=Valitse reunat
selectFont=Valitse fontti
selectVertices=Valitse verteksit
sendMessage=Send
sendUsYourFeedback=Send us your feedback
serviceUnavailableOrBlocked=Service unavailable or blocked
sessionExpired=Your session has expired. Please refresh the browser window.
sessionTimeoutOnSave=Your session has timed out and you have been disconnected from the Google Drive. Press OK to login and save. 
setAsDefaultStyle=Set as default style
shadow=Varjostus
shape=Muoto
shapes=Muodot
share=Jaa
shareLink=Linkki jaettuun muokkaukseen
sharingServerNotice=Huomio: Kokeellisia ominaisuuksia. Käyttäminen omalla vastuulla!
sharingServerReady=Jakopalvelin on nyt valmis.
sharingServerUnavailable=Jakopalvelin ei ole saatavilla.
signOut=Kirjaudu ulos
size=Koko
sourceSpacing=Lähteen väli
south=Etelä 
spacing=Väli
specialLink=Special link
starting=Starting
straight=Suora
strokeColor=Rivin väri
style=Tyyli
subscript=Subscript
superscript=Superscript
support=Support
table=Table
targetSpacing=Kohteen väli
template=Template
templates=Templates
text=Teksti
textAlignment=Tekstin sovittaminen
textOpacity=Tekstin peittävyys 
theme=Theme
tilt=Tilt
timeout=Timeout
toBack=Taakse
toFront=Eteen
tooltips=Työkaluvihjeet
top=Yläsivu
topAlign=Yläsivun tasaus 
transparent=Läpinäkyvä
tryAgain=Try again
underline=Alleviivattu
undo=Peruuta
ungroup=Pura ryhmitys
unsavedChanges=Unsaved changes
untitledDiagram=Untitled Diagram
untitledLibrary=Untitled Library
unknownError=Unknown error
updatingDocument=Päivitetään dokumenttia. Ole hyvä ja odota...
updatingSelection=Päivitetään valintaa. Ole hyvä ja odota...
upload=Upload
url=URL
vertical=Pystysuunta
verticalFlow=Pystysuuntainen vuo
verticalTree=Puunäkymä pystysuunnassa
view=Katso
west=Länsi
width=Leveys 
wordWrap=Word wrap
zoom=Zoomaa
zoomIn=Lähennä
zoomOut=Loitonna
basic=Basic
businessprocess=Business processes
charts=Charts
engineering=Engineering
flowcharts=Flowcharts
mindmaps=Mindmaps
mockups=Mockups
networkdiagrams=Network diagrams
other=Other
softwaredesign=Software design
venndiagrams=Venn diagrams
wireframes=Wireframes
