# *DO NOT DIRECTLY EDIT THIS FILE, IT IS AUTOMATICALLY GENERATED AND IT IS BASED ON:*
# https://docs.google.com/spreadsheet/ccc?key=0AmQEO36liL4FdDJLWVNMaVV2UmRKSnpXU09MYkdGbEE
aboutDrawio=عن تطبيق draw.io
actualSize=الحجم الحقيقي
add=Add
addImages=Add images
addImageUrl=Add image URL
addLayer=Add layer
addProperty=Add property
addToExistingDrawing=أضف إلى الرسم الحالي
addWaypoint=Add waypoint
advanced=Advanced
align=صُف
alignment=محاذاة
allChangesLost=سيتم فقد جميع التغييرات
areYouSure=Are you sure?
ensureDataSaved=Please ensure your data is saved before closing.
allChangesSaved=All changes saved
allChangesSavedInDrive=All changes saved in Drive
allowPopups=Allow pop-ups to avoid this dialog.
alreadyConnected=العقد متصلة مسبقا
apply=نفذ
arrange=رتب
arrow=سهم
arrows=أسهم
asNew=As new
atlas=Atlas
authorizationRequired=Authorization required
authorizeThisAppIn=Authorize this app in {1}:
authorize=Authorize
authorizing=Authorizing
automatic=Automatic
autosave=Autosave
autosize=تحجيم تلقائي
background=Background
backgroundColor=لون الخلفية
backgroundImage=Background image
basic=أساس
blankDrawing=تصميم فارغ
blankDiagram=Blank diagram
block=كتلة
blockquote=Blockquote
bold=تغليظ الخط
borderColor=لون الحد
borderWidth=عرض الحد
bottom=أسفل
bottomAlign=محاذاة إلى الأسفل
browser=Browser
bulletedList=Bulleted list
cancel=إلغاء
center=توسيط
cannotLoad=Load attempts failed. Please try again later.
cannotLogin=Log in attempts failed. Please try again later.
change=Change
changeOrientation=تغيير الاتجاه
changeUser=Change user
changesNotSaved=Changes have not been saved
chatJoined={1} has joined
chatLeft={1} has left
chatWindowTitle=Chat
chooseAnOption=Choose an option
chromeApp=Chrome App
circle=دائرة
classic=تقليدي
clipart=قصاصة فنية
close=إغلاق
collaborator=Collaborator
collaborators=Collaborators
collapse=إخفاء
collapse-expand=إخفاء/ إظهار الصفحات المفتوحة
collapsible=Collapsible
commentsNotes=Comments/Notes
connect=اتصل
connecting=اتصال
connectWithDrive=اتصل بجوجل درايف
connection=اتصال
connectionPoints=Connection points
containsValidationErrors=يوجد أخطاء يجب التأكد من صحتها
copy=نسخ
copyConnect=Copy on connect
copyOf=Copy of
copyOfDrawing=نسخة من الرسم
copyStyle=Copy style
create=Create
createNewDiagram=Create new diagram
curved=Curved
custom=تخصيص
cut=قص
dashed=متقطع
delete=حذف
deleteColumn=Delete column
deleteRow=Delete row
device=Device
diagramLocked=Diagram has been locked to prevent further data loss.
diagramName=Diagram name
diamond=شكل ألماسي
diamondThin=شكل ألماسي (رقيق)
didYouKnow=هل تعرف ...
direction=إتجاه
discardChangesAndReconnect=Discard changes and reconnect
googleDriveMissing=Google Drive missing?
disconnected=Disconnected
distribute=Distribute
documentProperties=Document properties
done=تم
dotted=Dotted
doubleClickOrientation=أنقر مرتين لتغيير الإتجاه
downloadAs=Download as
dragImagesHere=Drag images here
draw.io=draw.io
drawing=تصميم {1}
drawingEmpty=التصميم فارغ
drawingTooLarge=التصميم كبير للغاية
dropbox=Dropbox
duplicate=انسخ
east=شرق
edit=تعديل
editData=Edit data
editGeometry=Edit geometry
editImage=Edit image
editImageUrl=Edit Image URL
editLink=تعديل الرابط
editText=Edit text
editTooltip=Edit tooltip
googleImages=Google Images
imageSearch=Image Search
email=Email
embed=تضمين
mainEmbedNotice=Paste this into the page
embedNotice=أضف هذا مرة واحدة في نهاية الصفحة
enterGroup=ادخل تصنيف
enterName=Enter name
enterPropertyName=Enter property name
enterValue=ادخل قيمة
entityRelation=علاقة الكيانات
error=خطأ
errorLoadingFile=خطأ في تحميل الملف
errorRenamingFile=Error renaming file.
errorRenamingFileNotFound=Error renaming file. File was not found.
errorRenamingFileForbidden=Error renaming file. Insufficient access rights.
errorSavingFile=خطأ في حفظ الملف
errorSavingFileUnknown=Error authorizing with Google's servers. Please refresh the page to re-attempt.
errorSavingFileForbidden=Error saving file. Insufficient access rights.
errorSavingFileNotFound=Error saving file. File was not found.
errorSendingFeedback=Error sending feedback.
exit=Exit
exitGroup=مغادرة مجموعة
expand=إظهار
export=تصدير
failedToSaveTryReconnect=لم يتم الحفظ، محاولة إعادة الاتصال.
featureRequest=Feature Request
feedback=Feedback
feedbackSent=Feedback successfully sent.
file=ملف
filename=اسم الملف
fileExists=File already exists
fileNotFound=الملف غير موجود
fileNotFoundOrDenied=The file was not found. It does not exist or you do not have read access.
fileNotLoaded=لم يتم تحميل الملف
fileNotSaved=لم يتم حفظ الملف
fileOpenLocation=How would you like to open these file(s)?
fileWillBeSavedInAppFolder={1} will be saved in the app folder.
fillColor=تعبئة لون
fit=ملائمة
fitPage=ملائمة الصفحة
fitPageWidth=ملائمة عرض الصفحة
fitTwoPages=Two pages
fitWindow=ملائمة الشاشة
flipH=انعكاس أفقي
flipV=انعكاس عمودي
fontColor=لون الخط
fontFamily=الخط
fontSize=حجم الخط
forbidden=You are not authorized to access this file
format=تنسيق
formatted=Formatted
formattedText=Formatted text
forum=المناقشات/ منتديات المساعدة
fromTemplate=من قالب
fromTemplateUrl=From template URL
fromText=من نص
general=عام
global=عالمي
googleDocs=Google Docs
googleDrive=Google Drive
googleGadget=Google Gadget
googlePlus=Google+
googleSites=Google Sites
gradient=الميل
gradientColor=اللون
grid=شبكة
gridSize=Grid size
group=تصنيف
guides=أدلة
hateApp=I hate draw.io
heading=Heading
height=الارتفاع
help=مساعدة
helpTranslate=ساعدنا في ترجمة هذا التطبيق
hide=إخفاء
hideIt=Hide {1}
hidden=Hidden
home=الرئيسية
horizontal=أفقي
horizontalFlow=تدفق أفقي
horizontalTree=شجرة أفقية
html=HTML
htmlText=HTML text
iframe=IFrame
ignore=Ignore
image=صورة
images=صور
import=جلب
importFrom=Import from
includeCopyOfMyDiagram=Include a copy of my diagram
increaseIndent=Increase indent
decreaseIndent=Descrease indent
inline=مضمنة
insert=Insert
insertColumnBefore=Insert column left
insertColumnAfter=Insert column right
insertImage=Insert image
insertHorizontalRule=Insert horizontal rule
insertLink=Insert link
insertRowBefore=Insert row above
insertRowAfter=Insert row after
inserting=Inserting
invalidName=Invalid name
invalidOrMissingFile=ملف غير صالح أو غير موجود
italic=خط مائل
kennedy=Kennedy
layer=Layer
layers=Layers
landscape=طباعة بالعرض
language=لغة
lastChange=Last change {1} ago
lessThanAMinute=less than a minute
minute=minute
minutes=minutes
hours=hours
days=days
months=months
years=years
restartForChangeRequired=Changes will take effect after page refresh.
layout=التصميم
left=اليسار
leftAlign=محاذاة إلى اليسار
line=الخط
lineend=نهاية الخط
linestart=بداية الخط
linewidth=عرض الخط
link=Link
loading=تحميل
lockUnlock=Lock/Unlock
loveApp=I love draw.io
mathematicalTypesetting=Mathematical typesetting
makeCopy=Make a copy
manual=Manual
middle=وسط
more=More
moreResults=المزيد من النتائج
moreShapes=المزيد من الأشكال
move=تحريك
moveToFolder=Move to folder
moving=Moving
moveSelectionTo=Move selection to {1}
navigation=الملاحة
needHelp=Need help?
new=جديد
newLibrary=New library
noColor=لا يوجد لون
noFiles=لا يوجد ملفات
noFileSelected=No file selected
noMoreResults=لا يوجد المزيد من النتائج
none=لا شيء
noOtherViewers=No other viewers
noPlugins=No plugins
noResponse=No response from server
noResultsFor=لا توجد نتائج متعلقة بـ '{1}'
normal=Normal
north=شمال
notADiagramFile=Not a diagram file
notALibraryFile=Not a library file
notConnected=غير متصل
note=Note
notUsingService=Not using {1}?
numberedList=Numbered list
offline=Offline
ok=موافقة
opacity=معدل الشفافية
open=فتح
openArrow=فتح سهم
openExistingDiagram=Open existing diagram
openFile=فتح ملف
openFrom=Open from
openLibrary=Open library
openLink=فتح رابط
openInNewWindow=فتح في نافذة جديدة
openIt=Open {1}
openSupported=الصيغة المعتمدة هي الملفات ذات امتداد .XML المحفوظة من هذا البرنامج
options=الخيارات
organic=عضوي
orthogonal=متعامد
otherViewer=other viewer
otherViewers=other viewers
outline=Outline
oval=بيضاوي
pages=صفحات
pageView=مشاهدة الصفحة
pageSetup=إعداد الصفحة
pageScale=مقياس الصفحة
pan=تحريك
paperSize=حجم الصفحة
paste=لصق
pasteStyle=Paste style
perimeter=المحيط
blue=Blue
green=Green
gray=Gray
turquoise=Turquoise
yellow=Yellow
red=Red
pink=Pink
publicDiagramUrl=Public URL of the diagram
purple=Purple
plain=بسيط
plugins=Plugins
pluginUrl=Plugin URL
pluginWarning=The page has requested to load the following plugin(s):\n \n {1}\n \n Would you like to load these plugin(s) now?\n \n NOTE : Only allow plugins to run if you fully understand the security implications of doing so.\n
portrait=Portrait
position=الوضع
posterPrint=طباعة ملصق
preferences=التفضيلات
preview=معاينة
print=طباعة
properties=Properties
radialTree=Radial tree
readOnly=Read-only
reconnecting=إعادة الإتصال
redirectToPro=This file was created in draw.io pro. You will be redirected now.
convertToPro=The file will be converted for draw.io pro now.
realtimeTimeout=It looks like you've made a few changes while offline. We're sorry, these changes cannot be saved.
redo=إعادة تنفيذ الأمر
refresh=Refresh
rememberMe=Remember me
rememberThisSetting=Remember this setting
removeFormat=Clear formatting
removeFromGroup=إزالة من مجموعة
removeIt=Remove {1}
removeWaypoint=Remove waypoint
rename=Rename
renamed=Renamed
renameIt=Rename {1}
renaming=Renaming
replace={1} موجود بالفعل. هل تريد استبداله؟
replaceExistingDrawing=استبدال الرسم الحالي
required=required
reset=إعادة تعيين
resetWaypoints=Reset waypoints
resize=تغيير الحجم
retryingIn=Retrying in {1} second(s)
retryingLoad=Load failed. Retrying...
retryingLogin=Login time out. Retrying...
reverseEdge=Reverse edge
right=يمين
rightAlign=محاذاة إلى اليمين
rotate=قم بالتدوير
rotation=تدوير
rounded=دائري
save=حفظ
saveAs=حفظ كـ
saved=تم الحفظ
saveDiagramsTo=Save diagrams to
saving=جاري الحفظ
scrollbars=أشرطة التمرير
search=بحث
selectAll=تحديد الكل
selectEdges=تحديد الحواف
selectFont=تحديد الخط
selectVertices=تحديد القمم
sendMessage=Send
sendUsYourFeedback=Send us your feedback
serviceUnavailableOrBlocked=Service unavailable or blocked
sessionExpired=Your session has expired. Please refresh the browser window.
sessionTimeoutOnSave=Your session has timed out and you have been disconnected from the Google Drive. Press OK to login and save. 
setAsDefaultStyle=Set as default style
shadow=ظل
shape=شكل
shapes=الأشكال
share=انشر
shareLink=رابط للتحرير المنشور
sharingServerNotice=ملحوظة: هذه الخاصية في حيز التجربة. قم باستخدامها على مسؤوليتك!
sharingServerReady=خادم النشر جاهز.
sharingServerUnavailable=خادم النشر غير متاح.
signOut=تسجيل الخروج
size=حجم
sourceSpacing=تباعد المصدر
south=جنوب
spacing=التباعد
specialLink=Special link
starting=Starting
straight=مستقيم
strokeColor=لون الخط
style=نمط
subscript=Subscript
superscript=Superscript
support=Support
table=Table
targetSpacing=تباعد الهدف
template=Template
templates=Templates
text=النص
textAlignment=محاذاة النص
textOpacity=معدل شفافية النص
theme=Theme
tilt=Tilt
timeout=Timeout
toBack=إلى الخلف
toFront=إلى الأمام
tooltips=تلميحات
top=أعلى
topAlign=محاذاة إلى الأعلى
transparent=شفاف
tryAgain=Try again
underline=تسطير
undo=تراجع
ungroup=تفكيك المجموعة
unsavedChanges=Unsaved changes
untitledDiagram=Untitled Diagram
untitledLibrary=Untitled Library
unknownError=Unknown error
updatingDocument=تحديث الوثيقة. برجاء الانتظار...
updatingSelection=تحديث الاختيار. برجاء الانتظار...
upload=Upload
url=الرابط
vertical=عمودي
verticalFlow=تدفق عمودي
verticalTree=شجرة عمودية
view=عرض
west=غرب
width=العرض
wordWrap=Word wrap
zoom=تكبير
zoomIn=تكبير
zoomOut=تصغير
basic=Basic
businessprocess=Business processes
charts=Charts
engineering=Engineering
flowcharts=Flowcharts
mindmaps=Mindmaps
mockups=Mockups
networkdiagrams=Network diagrams
other=Other
softwaredesign=Software design
venndiagrams=Venn diagrams
wireframes=Wireframes
