# *DO NOT DIRECTLY EDIT THIS FILE, IT IS AUTOMATICALLY GENERATED AND IT IS BASED ON:*
# https://docs.google.com/spreadsheet/ccc?key=0AmQEO36liL4FdDJLWVNMaVV2UmRKSnpXU09MYkdGbEE
aboutDrawio=关于 draw.io
actualSize=实际尺寸
add=Add
addImages=Add images
addImageUrl=Add image URL
addLayer=Add layer
addProperty=Add property
addToExistingDrawing=添加到当前的图形
addWaypoint=Add waypoint
advanced=Advanced
align=对齐
alignment=对齐
allChangesLost=所有修改都不会被保存！
areYouSure=Are you sure?
ensureDataSaved=Please ensure your data is saved before closing.
allChangesSaved=All changes saved
allChangesSavedInDrive=All changes saved in Drive
allowPopups=Allow pop-ups to avoid this dialog.
alreadyConnected=节点已连接
apply=应用
arrange=排列
arrow=箭头
arrows=箭头
asNew=As new
atlas=Atlas
authorizationRequired=Authorization required
authorizeThisAppIn=Authorize this app in {1}:
authorize=Authorize
authorizing=Authorizing
automatic=Automatic
autosave=Autosave
autosize=自动调整大小
background=Background
backgroundColor=背景颜色
backgroundImage=Background image
basic=基本
blankDrawing=空图
blankDiagram=Blank diagram
block=块
blockquote=Blockquote
bold=粗体
borderColor=边框颜色
borderWidth=边框宽度
bottom=底
bottomAlign=底部对齐
browser=Browser
bulletedList=Bulleted list
cancel=取消
center=中心
cannotLoad=Load attempts failed. Please try again later.
cannotLogin=Log in attempts failed. Please try again later.
change=Change
changeOrientation=改变方向
changeUser=Change user
changesNotSaved=Changes have not been saved
chatJoined={1} has joined
chatLeft={1} has left
chatWindowTitle=Chat
chooseAnOption=Choose an option
chromeApp=Chrome App
circle=圆形
classic=经典
clipart=剪贴画
close=关闭
collaborator=Collaborator
collaborators=Collaborators
collapse=折叠
collapse-expand=折叠/展开
collapsible=Collapsible
commentsNotes=Comments/Notes
connect=连接
connecting=连接
connectWithDrive=Connect with Google Drive
connection=连接
connectionPoints=Connection points
containsValidationErrors=包含验证错误
copy=复制
copyConnect=Copy on connect
copyOf=Copy of
copyOfDrawing=复制图
copyStyle=Copy style
create=Create
createNewDiagram=Create new diagram
curved=Curved
custom=自定义
cut=剪切
dashed=虚线
delete=删除
deleteColumn=Delete column
deleteRow=Delete row
device=Device
diagramLocked=Diagram has been locked to prevent further data loss.
diagramName=Diagram name
diamond=菱形
diamondThin=菱形（细）
didYouKnow=你知道吗......
direction=方向
discardChangesAndReconnect=Discard changes and reconnect
googleDriveMissing=Google Drive missing?
disconnected=Disconnected
distribute=Distribute
documentProperties=Document properties
done=完成
dotted=Dotted
doubleClickOrientation=双击改变方向
downloadAs=Download as
dragImagesHere=Drag images here
draw.io=draw.io
drawing=图{1}
drawingEmpty=图画为空
drawingTooLarge=图过大
dropbox=Dropbox
duplicate=复制
east=东
edit=编辑
editData=Edit data
editGeometry=Edit geometry
editImage=Edit image
editImageUrl=Edit Image URL
editLink=编辑链接
editText=Edit text
editTooltip=Edit tooltip
googleImages=Google Images
imageSearch=Image Search
email=Email
embed=嵌入
mainEmbedNotice=Paste this into the page
embedNotice=在页尾添加一次
enterGroup=进入组
enterName=Enter name
enterPropertyName=Enter property name
enterValue=输入值
entityRelation=实体关系
error=错误
errorLoadingFile=加载文件错误
errorRenamingFile=Error renaming file.
errorRenamingFileNotFound=Error renaming file. File was not found.
errorRenamingFileForbidden=Error renaming file. Insufficient access rights.
errorSavingFile=保存文件错误
errorSavingFileUnknown=Error authorizing with Google's servers. Please refresh the page to re-attempt.
errorSavingFileForbidden=Error saving file. Insufficient access rights.
errorSavingFileNotFound=Error saving file. File was not found.
errorSendingFeedback=Error sending feedback.
exit=Exit
exitGroup=离开组
expand=展开
export=导出
failedToSaveTryReconnect=保持失败，尝试重新连接
featureRequest=Feature Request
feedback=Feedback
feedbackSent=Feedback successfully sent.
file=文件
filename=文件名
fileExists=File already exists
fileNotFound=没有此文件
fileNotFoundOrDenied=The file was not found. It does not exist or you do not have read access.
fileNotLoaded=文件无法加载
fileNotSaved=文件无法保存
fileOpenLocation=How would you like to open these file(s)?
fileWillBeSavedInAppFolder={1} will be saved in the app folder.
fillColor=填充颜色
fit=配合
fitPage=一页
fitPageWidth=页宽
fitTwoPages=Two pages
fitWindow=填满窗口
flipH=水平翻转
flipV=垂直翻转
fontColor=字体颜色
fontFamily=字体家族
fontSize=字体大小
forbidden=You are not authorized to access this file
format=格式
formatted=Formatted
formattedText=Formatted text
forum=讨论组/帮助论坛
fromTemplate=从模板
fromTemplateUrl=From template URL
fromText=从文本
general=通用
global=全局
googleDocs=Google Docs
googleDrive=Google Drive
googleGadget=Google Gadget
googlePlus=Google+
googleSites=Google Sites
gradient=渐变
gradientColor=颜色
grid=格子
gridSize=Grid size
group=组合
guides=参考线
hateApp=I hate draw.io
heading=Heading
height=高
help=帮助
helpTranslate=Help us translate this application
hide=隐藏
hideIt=Hide {1}
hidden=Hidden
home=首页
horizontal=水平
horizontalFlow=水平流
horizontalTree=水平树
html=HTML
htmlText=HTML text
iframe=IFrame
ignore=Ignore
image=图像
images=图像
import=导入
importFrom=Import from
includeCopyOfMyDiagram=Include a copy of my diagram
increaseIndent=Increase indent
decreaseIndent=Descrease indent
inline=内联
insert=Insert
insertColumnBefore=Insert column left
insertColumnAfter=Insert column right
insertImage=Insert image
insertHorizontalRule=Insert horizontal rule
insertLink=Insert link
insertRowBefore=Insert row above
insertRowAfter=Insert row after
inserting=Inserting
invalidName=Invalid name
invalidOrMissingFile=无效或丢失的文件
italic=斜体
kennedy=Kennedy
layer=Layer
layers=Layers
landscape=整体效果
language=语
lastChange=Last change {1} ago
lessThanAMinute=less than a minute
minute=minute
minutes=minutes
hours=hours
days=days
months=months
years=years
restartForChangeRequired=Changes will take effect after page refresh.
layout=布局
left=左
leftAlign=左对齐
line=线
lineend=线末端
linestart=线始端
linewidth=线宽
link=Link
loading=加载中
lockUnlock=Lock/Unlock
loveApp=I love draw.io
mathematicalTypesetting=Mathematical typesetting
makeCopy=Make a copy
manual=Manual
middle=中央
more=More
moreResults=更多结果
moreShapes=更多形状
move=移动
moveToFolder=Move to folder
moving=Moving
moveSelectionTo=Move selection to {1}
navigation=导航
needHelp=Need help?
new=新建
newLibrary=New library
noColor=无颜色
noFiles=无文件
noFileSelected=No file selected
noMoreResults=没有其他结果
none=无
noOtherViewers=No other viewers
noPlugins=No plugins
noResponse=No response from server
noResultsFor={1}’没有结果
normal=Normal
north=北
notADiagramFile=Not a diagram file
notALibraryFile=Not a library file
notConnected=没有连接
note=Note
notUsingService=Not using {1}?
numberedList=Numbered list
offline=Offline
ok=确定
opacity=透明度
open=打开
openArrow=打开箭头
openExistingDiagram=Open existing diagram
openFile=打开文件
openFrom=Open from
openLibrary=Open library
openLink=打开链接
openInNewWindow=在新窗口打开
openIt=Open {1}
openSupported=此软件支持的保存格式为.xml
options=选项
organic=有机
orthogonal=正交
otherViewer=other viewer
otherViewers=other viewers
outline=Outline
oval=椭圆形
pages=页面
pageView=页面视图
pageSetup=页面设置
pageScale=页面比例
pan=盘子
paperSize=页面尺寸
paste=粘贴
pasteStyle=Paste style
perimeter=周长
blue=Blue
green=Green
gray=Gray
turquoise=Turquoise
yellow=Yellow
red=Red
pink=Pink
publicDiagramUrl=Public URL of the diagram
purple=Purple
plain=平
plugins=Plugins
pluginUrl=Plugin URL
pluginWarning=The page has requested to load the following plugin(s):\n \n {1}\n \n Would you like to load these plugin(s) now?\n \n NOTE : Only allow plugins to run if you fully understand the security implications of doing so.\n
portrait=Portrait
position=位置
posterPrint=海报样式
preferences=喜好
preview=预览
print=打印
properties=Properties
radialTree=Radial tree
readOnly=Read-only
reconnecting=重新连接
redirectToPro=This file was created in draw.io pro. You will be redirected now.
convertToPro=The file will be converted for draw.io pro now.
realtimeTimeout=It looks like you've made a few changes while offline. We're sorry, these changes cannot be saved.
redo=重做
refresh=Refresh
rememberMe=Remember me
rememberThisSetting=Remember this setting
removeFormat=Clear formatting
removeFromGroup=从组中删除
removeIt=Remove {1}
removeWaypoint=Remove waypoint
rename=Rename
renamed=Renamed
renameIt=Rename {1}
renaming=Renaming
replace={1}已经存在了。要替换它吗？
replaceExistingDrawing=替换当前图形
required=required
reset=重置
resetWaypoints=Reset waypoints
resize=重新大小
retryingIn=Retrying in {1} second(s)
retryingLoad=Load failed. Retrying...
retryingLogin=Login time out. Retrying...
reverseEdge=Reverse edge
right=右
rightAlign=右对齐
rotate=旋转
rotation=旋转
rounded=圆角
save=保存
saveAs=另存为
saved=已保存
saveDiagramsTo=Save diagrams to
saving=保存中
scrollbars=滚动条
search=搜索
selectAll=选择全部
selectEdges=选择边
selectFont=选择一种字体
selectVertices=选择顶点
sendMessage=Send
sendUsYourFeedback=Send us your feedback
serviceUnavailableOrBlocked=Service unavailable or blocked
sessionExpired=Your session has expired. Please refresh the browser window.
sessionTimeoutOnSave=Your session has timed out and you have been disconnected from the Google Drive. Press OK to login and save. 
setAsDefaultStyle=Set as default style
shadow=阴影
shape=形状
shapes=形状
share=共享
shareLink=共享编辑的链接
sharingServerNotice=注意：试验功能。风险自负！
sharingServerReady=共享服务器已准备好。
sharingServerUnavailable=共享服务器无法使用。
signOut=登出
size=大小
sourceSpacing=源间距
south=南
spacing=间距
specialLink=Special link
starting=Starting
straight=直线
strokeColor=线颜色
style=风格
subscript=Subscript
superscript=Superscript
support=Support
table=Table
targetSpacing=目标间距
template=Template
templates=Templates
text=文本
textAlignment=文本对齐
textOpacity=字体透明度
theme=Theme
tilt=Tilt
timeout=Timeout
toBack=转到后面
toFront=转到前面
tooltips=提示
top=顶
topAlign=顶部对齐
transparent=透明
tryAgain=Try again
underline=下划线
undo=取消操作
ungroup=取消组合
unsavedChanges=Unsaved changes
untitledDiagram=Untitled Diagram
untitledLibrary=Untitled Library
unknownError=Unknown error
updatingDocument=更新文件。请稍候...
updatingSelection=更新选择。请稍候...
upload=Upload
url=链接
vertical=垂直
verticalFlow=垂直流
verticalTree=垂直树
view=视图
west=西
width=宽度
wordWrap=Word wrap
zoom=缩放
zoomIn=放大
zoomOut=缩小
basic=Basic
businessprocess=Business processes
charts=Charts
engineering=Engineering
flowcharts=Flowcharts
mindmaps=Mindmaps
mockups=Mockups
networkdiagrams=Network diagrams
other=Other
softwaredesign=Software design
venndiagrams=Venn diagrams
wireframes=Wireframes
